Tongjunzhuang north=Zelienople 
Xintan east=Abeytas west=SixShooterCanyon north=MorroBay 
Protivin east=Pioneer west=Dagangjiu north=GranvilleSouth south=Daoziba 
GrandMound west=Wildomar 
FujiaBeigou east=Fairgarden north=Hengkeng south=ConesusHamlet 
Xishan north=Mirantarium 
Jishui east=ClearviewAcres south=Ganbao 
Pioneer east=Antelope west=Protivin north=JAARS 
Hengkeng north=ArrowheadSprings south=FujiaBeigou 
Oostburg north=ConesusHamlet 
Hongpan Xiang west=Lengshuiwan 
PaintedHills west=Zelienople 
Kipton east=Ziyipu north=Dawan 
Fuche south=Westmont 
Xizhuangtou west=Ganbao north=ClearviewAcres south=ArrowheadSprings 
Syosset east=Alamo west=Bamian south=Shengdianzhuang 
Manahawkin west=Tecumseh 
Dushanwu east=Herington west=Shengdianzhuang north=Alamo 
ElkHorn west=Taunton 
BessemerBend south=Edinburg 
Shuangpeixia north=Tongziwo south=Peitaiho 
Xiaoqiao east=MapleHeights north=Huangtuling south=GranvilleSouth 
MapleHeights east=Ganbao west=Xiaoqiao north=Edinburg south=JAARS 
Daoziba west=Greilickville north=Protivin 
MorroBay south=Xintan 
Burnettsville east=Lüdazhuang west=Mirantarium 
Edinburg west=Huangtuling north=BessemerBend south=MapleHeights 
GranvilleSouth north=Xiaoqiao south=Protivin 
Tecumseh east=Manahawkin 
Taunton east=ElkHorn north=Greilickville south=RockCity 
RockCity east=Yadao west=Donghuanglou north=Taunton 
Yecitang east=Gonvick west=Abeytas 
Mirantarium east=Burnettsville west=Wutongmiao south=Xishan 
Peitaiho north=Shuangpeixia 
LakeCassidy east=Dagangjiu west=Whitakers south=Canandaigua 
Canandaigua east=Greilickville north=LakeCassidy south=Herington 
ConesusHamlet west=Xinzhuangcun north=FujiaBeigou south=Oostburg 
Kappa east=Jincun 
Qiaodong north=Maykhutu south=Funkley 
Hahira east=Funkley 
Westmont west=Langdaling north=Fuche south=Eschbach 
SixShooterCanyon east=Xintan 
ClearviewAcres west=Jishui north=Zena south=Xizhuangtou 
Manhattan east=Langdaling north=Maidigou 
JAARS north=MapleHeights south=Pioneer 
Alamo west=Syosset north=Whitakers south=Dushanwu 
Fairgarden west=FujiaBeigou 
Shengdianzhuang east=Dushanwu north=Syosset south=Sanxingzhen 
RanchoMirage north=Loufanggou south=Guanyinmiao 
Lüdazhuang east=Baiyang west=Burnettsville 
Dawan east=Lengshuiwan south=Kipton 
Ziyipu west=Kipton 
Huangyaoguan west=Sanxingzhen 
Loufanggou south=RanchoMirage 
Xinzhuangcun east=ConesusHamlet west=Dahuang south=Jincun 
Donghuanglou east=RockCity 
Guanyinmiao north=RanchoMirage 
Eschbach west=LeRaysville north=Westmont south=Whitakers 
Sedan east=Miaobei north=Wildomar south=LeadvilleNorth 
Antelope west=Pioneer 
Dahuang east=Xinzhuangcun 
Abeytas east=Yecitang west=Xintan 
Langdaling east=Westmont west=Manhattan 
Zena east=Tongziwo south=ClearviewAcres 
Dagangjiu east=Protivin west=LakeCassidy north=Fulford south=Greilickville 
Ganzhou south=Huangtuling 
Herington west=Dushanwu north=Canandaigua 
Yadao west=RockCity 
Huakengwu north=Jincun 
Baiyang west=Lüdazhuang 
Miaobei west=Sedan 
Ganbao east=Xizhuangtou west=MapleHeights north=Jishui south=Xiaojiaao 
Minzhu south=Shangyang 
LeRaysville east=Eschbach south=Zhengzhuang 
Sanxingzhen east=Huangyaoguan north=Shengdianzhuang 
Jincun west=Kappa north=Xinzhuangcun south=Huakengwu 
Wildomar east=GrandMound south=Sedan 
Tongziwo west=Zena south=Shuangpeixia 
Maidigou north=Wutongmiao south=Manhattan 
Fulford south=Dagangjiu 
ArrowheadSprings north=Xizhuangtou south=Hengkeng 
Maykhutu south=Qiaodong 
Lengshuiwan east=Hongpan Xiang west=Dawan 
Zelienople east=PaintedHills south=Tongjunzhuang 
Funkley west=Hahira north=Qiaodong 
LeadvilleNorth north=Sedan 
Xiaojiaao north=Ganbao 
Zhengzhuang west=Shangyang north=LeRaysville 
Whitakers east=LakeCassidy north=Eschbach south=Alamo 
Gonvick west=Yecitang 
Wutongmiao east=Mirantarium south=Maidigou 
Shangyang east=Zhengzhuang north=Minzhu south=Bamian 
Bamian east=Syosset north=Shangyang 
Greilickville east=Daoziba west=Canandaigua north=Dagangjiu south=Taunton 
Huangtuling east=Edinburg north=Ganzhou south=Xiaoqiao 
